Bryn	Gasker
Antony	Boam
Chelsae	Bewshea
Nancey	Heimes
Sylvan	Richly
Aigneis	Thornewill
Care	McCarty
Andrew	Ciccarelli
Esmeralda	Holsey
Nickolai	Chase
Brianne	Andrich
Merridie	Jacson
Kelsy	Linnit
Griselda	Tebbet
Pavia	MacGlory
Katheryn	Overil
Noella	Kauble
Devan	Probey
Drew	Farnes
Bethanne	Andrasch
Torr	Kinton
Tedi	Haylett
Gorden	Mattersley
Levon	Cogley
Sandi	Bavridge
Kathe	Goodbanne
Erna	Sigsworth
Helena	Beinke
Ring	Brideoke
Hewitt	Gartan
Sam	Gaskal
Tuckie	Gamblin
Gradeigh	Evetts
Teodorico	Merrin
Emylee	Scohier
Graeme	Pitway
Karee	Palk
Loretta	Crawford
Ealasaid	Stanier
Bard	Curdell
Jasun	Al Hirsi
Tibold	Eastbury
Tera	Heggison
Valida	Chaffer
Jermain	Cruwys
Elberta	Dennett
Lindsey	Colgrave
Vincents	Thompsett
Lou	Beesey
Payton	Doone
Desiree	Swayton
Ricoriki	Chantillon
Dell	Keetch
Ferdinand	Slayton
Lauraine	Azema
Jerome	McGahey
Gwyn	Dolbey
Ephraim	Attwell
Hendrik	Clemoes
Kenn	Bess
Jeanelle	Grute
Harv	Cutteridge
Celia	Berceros
Dannel	Breewood
Maxim	Dulson
Theda	Denisevich
Larisa	Mergue
Colin	Porcher
Cindelyn	Hawkswood
Stuart	McCritichie
Calypso	Kropach
Vitia	Spurman
Bobby	Ridel
Gaven	Staining
Elladine	Averay
Jojo	Parzis
Brittni	Kitchen
Claretta	Hebbs
Niel	Nast
Almeria	Syplus
Donnamarie	Tuckwood
Nichol	Learie
Emelyne	Milham
Kristoforo	Ruxton
Axel	Cussen
Cordi	Esplin
Rex	Rudall
Hobey	Taber
Audra	Qualtro
Tomi	Wilsdon
Alethea	Shilburne
Goldina	Laying
Etienne	Torrecilla
Bobbye	Giacovelli
Miranda	Nuton
Lorrin	Saines
Mortie	Goodday
Godwin	Glide
Curtis	Settle
Joan	Jermey
Frasier	Rawlison
Ephraim	Costell
Nikki	Mc Meekan
Calypso	Rosenkrantz
Blondie	Hyatt
Shelagh	Cherrison
Antonie	Sent
Thorsten	Cristofori
Hoebart	Pettendrich
Caterina	Grigorian
Lorri	Splaven
Brice	Dominy
Norris	Bartlam
Layla	Trustie
Shepherd	Daout
Megan	Archanbault
Humphrey	Bleier
Leonie	Nudds
Gus	Picard
Nikolas	McDermot
Zsa zsa	Peace
Sylvia	Dansken
Carrie	Gendricke
Idalina	Clyburn
Amalle	Botten
Shirl	Waycott
Justinn	Ciccoloi
Nikolia	Prestige
Krysta	Stapforth
Jacquelynn	Gauden
Alfi	Mandrake
Lurette	Leaton
Aldis	Swayland
Rex	Pudner
Dix	Jacmar
Eldon	Cavie
Sharyl	Malim
Obie	Leander
Calypso	Manueau
Che	Colerick
Melly	Blues
Waylen	Fothergill
Laureen	Goard
Dorris	Hainge
Brooke	Glassard
Florencia	Brownill
Willi	Durrand
Geoffrey	Zecchinii
Locke	Fotherby
Tabbie	Reddle
Rich	Duffell
Gifford	Kirkup
Norrie	Boddy
Elke	Basillon
Percy	Caird
Yoshiko	Beardwell
Demeter	Comellini
Hulda	Klarzynski
Caro	Flanigan
Eddi	Demcik
Beryl	Kaygill
Bob	Milton-White
Alberik	McMechan
Eldin	Goathrop
Nickolai	Campey
Steffie	Ramsby
Aarika	Briatt
Nevil	Ferraretto
Zeke	Horsburgh
Carena	Sheridan
Milo	Antoni
Zilvia	Edgar
Delora	Brader
Perkin	Dwelling
Kaspar	Dobey
Agnes	Tales
Camel	Fronks
Anthe	Shardlow
Elke	Gavrieli
Bronson	Itschakov
Lorrie	Kingswoode
Tyson	Hyatt
Rana	Neames
Si	Berrick
Odell	Cansdill
Ignaz	Danis
Lanny	Stitwell
Shane	Selway
Rachele	Weepers
Ronny	Eastbrook
Noell	Palethorpe
Madge	MacRonald
William	Fickling
Katharyn	Gawthrop
Crissy	Hawkswood
Petronella	Iorillo
Mira	Taffurelli
Ninon	Cudde
Adelaida	Winks
Irene	Duchart
Curry	Bunclark
Pail	Macauley
Lura	Cossons
Douglass	Fowgies
Maurise	Latch
Harvey	Stiggers
Pattin	Pfeffel
Dorey	McKelvie
Meyer	Pyffe
Nicky	De Ambrosi
Karlen	Hyatt
Sandye	Sankey
Nikki	Tippin
Allie	Drewe
Jacques	Pettit
Matthaeus	Kenion
Husein	McIlheran
Benjamin	Coleyshaw
Petronilla	Peaddie
Maribelle	Bosket
Kellyann	Poveleye
Codie	Stonman
Farah	Brawson
Tabbie	Thoumas
Clea	Hawkin
Hale	Sunner
Bobbette	Goddard
Emelen	Pebworth
Morena	Topp
Keene	Lorain
Elbertine	Munkley
Uriel	Itzhayek
Abagail	Nan Carrow
Serena	Beagrie
Darb	Frankum
Simona	Weatherup
Zarah	Gatiss
Angy	Fourcade
Vonny	Muccino
Jory	Deniscke
Anthia	Nineham
Tessie	Athow
Madlin	Olivet
Brnaby	McCarroll
Emmalynn	Glasson
Oralla	McVee
Enrichetta	Bims
Desiree	Blondin
Antonius	Filoniere
Lidia	Preddy
Dunstan	Chesshire
Ashlee	Bendan
Ebony	Lanfear
Lars	Attiwill
Barty	Riordan
Kaylil	Giannini
Ulla	Franca
Evyn	Luxmoore
Evan	Fisher
Kevin	Tollerfield
Eartha	Collumbell
Brianne	Trime
Peder	Fine
Rik	Woodroof
Guy	Zavittieri
Ashly	O'Kenny
Diandra	Amoore
Marla	Braidman
Ellette	Antonin
Ernesto	Sherrard
Tyrus	Drinkwater
Hope	Haigh
Austine	Bravery
Noelyn	Ridsdell
Gino	Pickover
Aloise	Woodlands
Arther	Derx
Judd	Abad
Donal	Bartoli
Ode	Reilinger
Patricio	Kemell
Francine	Degoey
Clerkclaude	Rubinowitsch
Vassili	Kolis
Debor	Edel
Kenn	Tille
Farly	Bastone
Tony	Huxtable
Kalila	Teggin
Gerhard	Killough
Sileas	Bamling
Rori	Rodenborch
Ben	Burnhard
Shawna	Landsbury
Colline	Binnall
Barbabra	Holwell
Elset	Hiscoe
Montgomery	Ocklin
Ardene	Quidenham
Ulrike	De la croix
Brent	Huddlestone
Ingram	Daintry
Janie	Skelcher
Lorilyn	Extall
Leta	Gimert
Mattheus	Marxsen
Gustie	Dilks
Lanny	Bagger
Mathew	Cutbirth
Loralyn	Shiel
Moise	Minett
Vanya	Titta
Grazia	De Cruze
Violette	O'Kerin
Colver	Mattingley
Gery	Myles
Clemmie	Sauvan
Hubert	Cason
Helaina	Moorman
Myranda	Redmell
Jess	Smurfitt
Portia	Crosswaite
Beret	Page
Arel	Florentine
Caesar	Hugues
Devinne	Knibb
Edwin	Mays
Halsey	Alkin
Fawne	Hutcheons
Virgie	Zamorrano
Anette	Meron
Suellen	Duns
Alexia	Galgey
Marguerite	Burnard
Philomena	Pole
Bernie	Brownlee
Edythe	Woodrooffe
Sebastien	Terbrug
Jeffy	Aldwick
Ricki	Hugh
Charla	Jerschke
Cherise	Gosneye
Ginnifer	Besnard
Persis	McCafferty
Matt	Craft
Marcus	Syversen
Abagael	Davitt
Calvin	Iron
Albert	Larmett
Linea	Brakespear
Hugibert	Broadwood
Derk	Spatari
Irvine	Frears
Miquela	Lloyds
Raynard	Blackmuir
Quentin	MacCawley
Jenine	Spensley
Zacharias	Almeida
Robbert	Gallahue
Fanni	Dahl
Inglis	Bucknell
Karel	Longhorne
Milli	Buxton
Stace	Josef
Jeffrey	Lattimore
Gabriella	Imort
Winny	Gillbee
Mikel	Schankel
Alta	Sarrell
Demetra	Watford
Scarlett	O'Neal
Agace	Fitzpatrick
Samantha	Sadat
Carce	Rodolphe
Charyl	Mullins
Agustin	Dewes
Katleen	Geare
Bertha	Orrey
Zachery	Glossop
Gianina	Ashtonhurst
Elfrida	Clee
Elia	Harron
Elora	Tye
Joannes	Wilcock
Karin	Giacovazzo
Corette	Hakewell
Krishnah	Farquhar
Ingeberg	Klouz
Corny	Haeslier
Torry	Beaufoy
Lazarus	Greenman
Keane	Ferreras
Suzy	Tilney
Cos	Le Noury
Mable	Sessions
Agosto	Twede
Lynna	Woodstock
Lisbeth	Philp
Josee	de Mullett
Kerk	Glassup
Dante	Joseff
Araldo	Sotworth
Misty	Hatz
West	Skipsea
Ann	Clooney
Timothy	Ivetts
Oberon	MacHarg
Jaquelin	McSperrin
Darryl	Dishman
Dorey	Demcak
Adelbert	Walczynski
Renado	Larn
Annabal	Clyde
Niko	Curtain
Ericha	Betton
Lammond	O'Reilly
Mag	Magrannell
Sylas	Burkman
Rickey	Clementi
Felipe	Edkins
Clevie	McNeachtain
Timmi	Wyon
Sybille	Garth
Thomasine	Ream
Inger	McConnachie
Doria	Tramel
Renado	Thoresbie
Aeriel	Ree
Arlina	Purcell
Merola	Trotman
Humfrey	Claremont
Randee	McFie
Nona	Scarce
Lula	Bakhrushin
Marie-ann	Gue
Malynda	Swinney
Phylys	Amps
Randene	Fuzzens
Constanta	Yaus
Armin	Morsom
Vania	Pilkinton
Karol	Frizzell
Lois	MacKenney
Mercie	Tomenson
Viv	Chartman
Hy	Cosstick
Dev	Lulham
Babb	Mutlow
Rodger	Pettett
Giacobo	Girardey
Celina	Brodley
Marcy	Kleis
Rebe	Coffelt
Blithe	Freiburger
Menard	Coste
Noelyn	Crake
Klarika	MacIan
Loren	Bridgeman
Rand	Hayfield
Nancey	Duffit
Caddric	Lamba
Raquela	Bonnick
Erl	McNickle
Kahaleel	Pavel
Dyann	Dorie
Ric	Sutherel
Cathlene	Riglar
Cornall	Grioli
Vera	Scholler
Jenni	Huxham
Leigh	Dominik
Kayley	Clipsham
Kathy	Sidlow
Gene	Keeting
Adeline	Mulder
Fonzie	Jakoub
Prinz	Mustard
Gabbey	Craven
Zahara	Harbinson
Shelton	Iowarch
Noam	Schaumaker
Luise	Jeandin
Rodolfo	Ewell
Bernardo	Landes
Talyah	Nicholes
Sebastien	Dabinett
Meghan	Pladen
Symon	Lucas
Abelard	Occleshaw
Haskell	Milmo
Jacenta	Shuker
Orson	Smiley
Ibbie	Tipling
Silvia	Venes
Fred	Perroni
Murry	Clayworth
Issi	Gonsalvo
Blancha	Coger
Luciana	Godilington
Casie	Maccraw
Zechariah	Dachs
Murry	Dinwoodie
Layla	Piscotti
Selle	Malcolm
Merline	Dryburgh
Dorree	Gaitskell
Wylie	Gownge
Eduardo	Isaq
Caterina	Joney
Fancy	Drewitt
Anita	Bragge
Lark	Bernocchi
Valaria	Flores
Aksel	O'Griffin
Jessalin	Scargill
Chryste	Egginson
Kev	Bradneck
Shoshana	Hollow
Urban	Harsant
Alaster	Crummie
Marcella	Hazzard
Jodee	Huggan
Gabbey	Brumble
Stormy	Hickisson
Sawyere	Langthorn
Malvin	Pergens
Deedee	Hutley
Nicole	Brambley
De	Stallon
Aloysia	Spreag
Ainslee	Tilston
Grover	Fenton
Genna	Wehnerr
Doll	Robart
Nahum	Veneur
Quinlan	Eatttok
Lorilyn	Chumley
Berget	Reignolds
Hillary	Dunnion
Gib	Briskey
Sherm	Kreutzer
Consuela	Harber
Astra	Grumble
Kacy	Sawers
Eileen	Thayre
Tibold	Rolling
Sisile	Lenden
Smith	Nehls
Marjorie	Tomasello
Selina	Secker
Yule	Fazan
Zedekiah	Lints
Astrid	Laise
Bryant	Sertin
Fianna	Gabotti
Feodora	Kunzel
Colver	Sciacovelli
Aurilia	Skipperbottom
Harriot	Erington
Blakeley	Cogdon
Goddart	Westmarland
Flore	Caherny
Noe	Broddle
Janith	Monkleigh
Micheal	Toffts
Maighdiln	Maryott
Charlot	Shire
Sofia	Clarey
Elmore	Eburah
Latisha	Eynon
Alexina	Trengrove
Glad	Sumsion
Ainslee	Spraging
Joseph	Wager
Catrina	Dishman
Gaile	Talton
Diego	Rubinsaft
Findley	Kuller
Odo	Gocher
Nonnah	Spurdle
Wallache	Nozzolii
Frannie	Bradick
Alameda	McGannon
Zsazsa	Venmore
Cristal	Sawell
Jordain	Corteis
Robina	Jira
Thane	Larkcum
Gaylord	Bastistini
Gracia	Sergison
Phillida	Milbourn
Tiena	Elderidge
Wang	Dignall
Mari	Lunk
Pascal	Basketter
Kailey	Sutlieff
Darsie	Eles
Addie	Kimmitt
Lorenza	Fleetwood
Donnie	Gazey
Evered	Boucher
Bradney	Haughian
Lyndsay	Yakhin
Oby	Swane
Frannie	Antonazzi
Barnard	Camies
Asa	Perview
Corrina	Georgelin
Pattie	Drakes
Devy	Tilt
Sheilah	Fraulo
Farleigh	Thirlaway
Reba	Mannin
Kordula	Applegate
Kenn	Molan
Leonidas	Gartin
Boote	Addionizio
Fawn	Schiersch
Josefa	Behning
Henriette	Gealle
Karola	Severns
Joanna	Daffey
Thom	Deighan
Pieter	Battany
Lynelle	Brooks
Staford	Mogg
Demott	Brewett
Jerome	Embra
Zabrina	Dashwood
Terrill	Dineges
Demetria	Spurr
Niki	Lumsden
Sterling	Le Port
Winonah	Hapgood
Agna	Arrow
Dacy	Pitkins
Staci	Broyd
Royall	Locks
Vicky	Wippermann
Burk	Burgott
Arlina	Cutten
Ximenez	Triggol
Sampson	Maber
Fredrick	Gilman
Cyndia	Bennitt
Wendeline	Bockett
Jana	Puddephatt
Cornelia	Valois
Gaultiero	Bromont
Kathlin	Iacoboni
Myrilla	Franca
Saxe	Napolitano
Jamima	Cahan
Theresa	Stoate
Mel	Carcass
Brittan	Hryncewicz
Aldous	Telezhkin
Yettie	MacGahey
Marysa	Teggin
Kiel	Wicher
Boot	Farloe
Ruttger	Errigo
Ruthy	Kenningley
Sloane	Pedroni
Oren	Emms
Boyce	Koop
Bordy	Tumilson
Leupold	Coldrick
Allen	Lomasny
Carilyn	Kausche
Gerik	Drewitt
Deirdre	Bohike
Kelsy	Sadat
Prudi	Deex
Roz	Powlesland
Corabelle	Verlander
Jefferey	Asman
Ruthanne	Cassius
Lennard	Defond
Derick	Sidle
Birk	Francescozzi
Laure	Cratchley
Wilone	Toland
Chaim	Drezzer
Romona	Massey
Issie	Schwand
Laure	Tames
Ortensia	Alliston
Jermain	Recher
Launce	Lettington
Harmon	MacGow
Edyth	Werny
Karlan	Gentle
Lou	Chantrell
Adella	Belsham
Philippe	De Blasio
Laetitia	Middlemass
Lynnett	Gilby
Miranda	Jan
Korie	Hallford
Yule	Tarbet
Hettie	Gladbach
Deeann	Bewshire
Jemimah	Couroy
Cornelia	Mateiko
Lurette	Ickowics
Andrus	Gresley
Thain	Cleugh
Debee	Le Floch
York	Allpress
Quincey	McCabe
Catlin	Troup
Egbert	Hubbis
Darell	Studeart
Salomi	Coviello
Dorotea	Faulks
Linda	Light
Larine	Hancill
Brittan	Climpson
Maximilianus	Clynmans
Lillis	Kiss
Mirabella	Domniney
Dick	Bundock
Armin	Leverett
Myer	Ridd
Conan	Jannings
Willette	Hanigan
Tim	Shilburne
Neilla	Rowthorne
Pammy	Gammon
Beverley	Rammell
Retha	Fenich
Gallard	Allmond
Pattie	Treanor
Rozalie	Colum
Dimitri	Sambeck
Edi	Bushell
Verena	Tull
Chelsey	Weightman
Rodrigo	Emer
Morty	Hasker
Lavinie	Ladds
Lissie	Aggus
Boycey	Fosbraey
Elvira	Weatherell
Bill	Meneer
Sandy	Hrynczyk
Sada	Babe
Horace	Chritchlow
Benni	Chretien
Cecily	Castle
Cristabel	Rolance
Claudell	O'Driscole
Tulley	Bonney
Susanne	Dibdale
Randall	Benettelli
Alie	Tottie
Selene	Spurdon
Aleda	Bessent
Tammi	Wallbutton
Steffi	Orhtmann
Catarina	Boame
Darrell	Standen
Susette	Follit
Renard	Spreckley
Tabbitha	Tanser
Garrott	Marzelli
Micheline	La Padula
Robbie	Moyne
Grove	McCreery
Romeo	Goldthorpe
Andriette	Tradewell
Kinsley	Pantecost
Henderson	Alberts
Davis	People
Dusty	Clavering
Farlee	Odom
Melanie	Minogue
Nikola	Kennermann
Maddi	Thorlby
Brooke	Mossman
Devinne	Wedmore
Scotty	McLarty
Robbyn	Adolthine
Koralle	Webby
Benji	Fernehough
Goldie	Prisley
Belle	Franca
Miles	Wase
Townie	Barmby
Lynea	Harriss
Marina	Jacquemard
Verge	Vauls
Elane	Risson
Randal	Deakan
Leontyne	Jarrold
Pat	Merrisson
Dorthy	Ream
Jeremy	Spight
Tommy	Armal
Issi	McGrah
Lawton	Lorrain
Ramonda	Tale
Sara-ann	Scheu
Eloisa	Greader
Lauren	Hedgeman
Shirleen	Curzon
Lin	Harm
Jackie	Quartermain
Greg	Whetland
Bartholomeus	Mingard
Miranda	Stooke
Mamie	Stennet
Yardley	Nouch
Broderick	Cruft
Barbabas	Towson
Ange	Le Teve
Torey	Donnan
Jacobo	Billo
Hedvige	Heaphy
Erhart	Gaishson
Luca	Purvis
George	Nendick
Ciel	Blaxland
Royall	Zisneros
Raimund	Howey
Tildi	Bawles
Jana	Johns
Sig	Saunt
Dian	Stichall
Lenard	Dobing
Natale	Arnli
Dorian	Fleckno
Romain	Duthie
Blakeley	Fiddyment
Ketti	Puddefoot
Brady	Messum
Emogene	Duding
Sebastien	Lacroux
Huntley	Syratt
Marley	Probbing
Ingelbert	Copestick
Vinson	Enriquez
Corey	Fynn
Corliss	Pretley
Yance	Bruckshaw
Dell	Oddie
Fiorenze	Vakhrushin
Creigh	Rentoll
Kerwinn	Gallandre
Jan	Mayow
Staford	Waterdrinker
Josiah	Purchall
Felicity	Gosenell
Reid	Guyot
Talyah	Shipcott
Lise	Oughtright
Kakalina	Leachman
Shell	McReedy
Kora	Gueny
Clywd	Matysiak
Aylmar	Epinay
Lexine	Dudney
Hubey	Gethen
Kelby	Killimister
Florenza	Alexsandrowicz
Tabbi	Skip
Carmina	Brisson
Roxanna	Corringham
Engracia	Bullick
Wren	Gristwood
Dayna	Hoodlass
Liana	Rosenblad
Babs	Gauvain
Raddie	Bock
Arleen	Nund
Tadeo	D'Hooghe
Mirella	Sculpher
Wendye	Churchin
Lorilee	Hannen
Clementina	Batts
Tilly	Baudins
Henriette	Colhoun
Brenna	Tunny
Ebonee	Daunay
Ethelbert	Clacson
Gnni	Rawlence
Camella	Cake
Babbie	Tacey
Dario	Torri
Helsa	O'Shesnan
Ada	Ventham
Sissie	Mosten
Avrom	Putten
Scott	Snepp
Jewell	Rosencrantz
Ardisj	Wiles
Robert	Buesden
Boot	MacLaren
Dollie	Blazeby
Cyb	Daft
Jeffrey	Mathie
Ediva	Pittaway
Magdalene	Kelway
Lurette	Flay
Shurwood	Alderman
Alleen	MacRinn
Pam	Amott
Den	Tomsa
Erwin	Suett
Camila	Paolazzi
Ramonda	Rablan
Kissee	Ibbotson
Garvy	Levane
Zeke	Breslauer
Mufinella	Kleinschmidt
Wendy	Clogg
Merlina	Stennet
Raquel	Eastcott
Moishe	Lamshead
Vivianna	Dobrowlski
Verne	Squeers
Baudoin	Ox
Omar	Harkness
Darda	Spiers
Agosto	Goering
Wendi	Iddon
Wyatan	Gorghetto
Niel	Billingsly
Maurise	Beardsall
Retha	Fessier
Bentley	Faulks
Ingelbert	Adam
Robb	Macveigh
Farand	Broggini
Tremain	Alford
Toddie	Geck
Meghan	Jobe
Moselle	Richardsson
Emanuele	Ibell
Tildie	Polendine
Immanuel	Corking
Jen	Wimlet
Berkley	Antram
Tabbie	Vasovic
Mireielle	Aykroyd
Odelia	Senten
Danice	Clive
Lucas	Pie
Evonne	Pegler
Jaine	Purdom
Abran	Hammer
Felike	Keston
Jakob	Probyn
Thorny	Dunnan
Alexio	Arangy
Kliment	Swindells
Marcelline	Joslyn
Linnea	Blackaller
Clarissa	Grinaway
Rubi	Clink
Owen	Batchelor
Filmore	Dales
Dwayne	Korpal
Malvin	Vlach
Marshall	Hartridge
Carly	Bencher
Faulkner	Harmer
Cyndy	Rodbourne
Ermentrude	O'Hoolahan
Edwina	Killford
Demetre	Mucklo
Zahara	Littleton
Wendy	Crozier
Harry	Abell
Frederick	Moulsdale
Ulberto	Turnock
Othilia	Servante
Wittie	Larkins
Bartolomeo	Ilyenko
Gretta	Quarrington
Conrad	Tours
Ikey	Videler
Koralle	Adolfson
Crawford	Greenhowe
Maurine	Collyns
Emmie	Astupenas
Blake	Iredale
Cecily	Sjollema
Earvin	Ortell
Goober	Vaggs
Winfred	Ferron
Valeda	Nickoles
Abagail	Stinton
Maryl	Dubery
Farr	Scholz
Adena	Nation
Dulcie	Elvy
Leslie	Tavernor
Georgy	Verna
